14 20 8 10
====================
=........o.........=
=.================.=
=..................=
=.================.=
=..................=
=.====_______=.===.=
=o====       =.===o=
=.============.===.=
=..................=
=.================.=
=.================.=
=........o.........=
====================