9 17 3 8
=================
.......o.........
=.===_______===.=
=.===       ===o=
=o=============.=
..=...........=..
=.==.=====.====.=
=<..............=
=================